O12345678901234567890123456789010
iSSSSSSSMSSSSSSSSSSSSSSSMSSSSSSSi
iSSSSSSSSSSSSSSSSMSSSSSSSSSSSSSSi
iSSSSS%%%%%%%%%%%%%%%%%%%%%HHHHHi
iSSSSS%NNNNNNNNNNNNMNNNNNN%HHHHHi
iSSSSS%NNNNNNMNNNNNNNNNNNN%HHHHMi
iSMSSS%NNNMNN%%%%%%%%NNNNN%HHHHHi
iSSSSS%NNNNNNFFFFFFF%MNNNN%HHHHHi
iSSSSS%NNNNNNFFFFFFF%NNNNN%HHHHHi
iSSSSS%NNNNNNFFFFFFF%NNNNN%HHHHHi
iSSSSM%NNNNNNFFFFFFF%NNNM %HHHHHi
iSSSSS%NNNNNNFFFFFFF%NNNNN%HHHHHi
iSSSSS%%%%%%%%%%%%%%%NNNNN%MHHHHi
iSSSSSSSSSSNNNNNNNNMNNNNNN%HHHHHi
iSSSSSSSSSMNNNNNNNNNNNNNNN%HHHHHi
i%%%%%%%%%%%%%%%%%%%%%%%%%%HHHHHi
iHHHHHHHHHHHHHHHHHHMHHHHHHHHHHHHi
iHHHHHHHHHHHHHHHHHHHHHHHHHHHHHHHi
O1234567890123456789012345678901O

% = Mur
F = Boss
M = Mechant

H = Herbe
S = Sable
N = Neige
