XYAAAAAAUTTTTTTTTTTTTTTTTTTTTPQO
Z?BBBBBBVWWWWWWWWWWWWWWWWWWWWRSO
HI$%%%%%%%%%%%%%%%%%%%%%%%%>(MNO
HI(XYAAAAAUTTTTTTTTTTTTTTTPQ<MNO
HI<Z?BBBBBVWWWWWWWWWWWWWWWRS<MNO
HI<HI$%%%%%%%%%%%%%%%%%%>(MN<MNO
HI<HI(OOOOOOOOOOOOOOOOOOO<MN<MNO
HI<HI<OOOOOOOOOOOOOOOOOOO<MN<MNO
HI<HI)OOOOOOOOOOOOOOOOOOO<MN<MNO
HI<!:AOOOOOOOOOOOOOOOOOOO<JK<MNO
HI<#@BOOOOOOOOOOOOOOOOOOO)HI<MNO
HI)$%%%%%%%%%%%%%%%%%%%%%>HI<JKL
!:AAAAAAAAAAAAAAAAAAAAAAAADE<HIC
#@BBBBBBBBBBBBBBBBBBBBBBBBFG)HIC
$%%%%%%%%%%%%%%%%%%%%%%%%%%%>HIC
AAAAAAAAAAAAAAAAAAAAAAAAAAAAADEC
BBBBBBBBBBBBBBBBBBBBBBBBBBBBBFGC
CCCCCCCCCCCCCCCCCCCCCCCCCCCCCCCC


