SSSSSSSSSSSSSSSSSSSSSSSSSSSSSSS
SSSSSSSSSSSSSSSSSSSSSSSSSSSSSSS
SSS%%%%%%%%%%%%%%%%%%%%%%%%%HHH
SSS%NNNNNNNNNNNNNNNNNNNNNNN%HHH
SSS%NNNNNNNNNNNNNNNNNNNNNNN%HHH
SSS%NNN%%%%%%%%%%%%%%%%%NNN%HHH
SSS%NNN%FFFFFFFFFFFFFFF%NNN%HHH
SSS%NNN%FFFFFFFFFFFFFFF%NNN%HHH
SSS%NNN%FFFFFFFFFFFFFFF%NNN%HHH
SSS%NNNFFFFFFFFFFFFFFFF%NNN%HHH
SSS%NNNFFFFFFFFFFFFFFFF%NNN%HHH
SSS%%%%%%%%%%%%%%%%%%%%%NNN%HHH
SSSSSSSSSSNNNNNNNNNNNNNNNNN%HHH
SSSSSSSSSSNNNNNNNNNNNNNNNNN%HHH
%%%%%%%%%%%%%%%%%%%%%%%%%%%%HHH
HHHHHHHHHHHHHHHHHHHHHHHHHHHHHHH
HHHHHHHHHHHHHHHHHHHHHHHHHHHHHHH


