SSSSSSSSSSSSSSSSSSSSSSSSSSSSSSSS
SSSSSSSSSSSSSSSSSSSSSSSSSSSSSSSS
SS%%%%%%%%%%%%%%%%%%%%%%%%%%%HHH
SS%NNNNNNNNNNNNNNNNNNNNNNNNN%HHH
SS%NNNNNNNNNNNNNNNNNNNNNNNNN%HHH
SS%NN%%%%%%%%%%%%%%%%%%%%%NN%HHH
SS%NN%FFFFFFFFFFFFFFFFFFF%NN%HHH
SS%NN%FFFFFFFFFFFFFFFFFFF%NN%HHH
SS%NN%FFFFFFFFFFFFFFFFFFF%NN%HHH
SS%NNNFFFFFFFFFFFFFFFFFFF%NN%HHH
SS%NNNFFFFFFFFFFFFFFFFFFF%NN%HHH
SS%%%%%%%%%%%%%%%%%%%%%%%%NN%HHH
SSSSSSSSSSNNNNNNNNNNNNNNNNNN%HHH
SSSSSSSSSSNNNNNNNNNNNNNNNNNN%HHH
%%%%%%%%%%%%%%%%%%%%%%%%%%%%%HHH
HHHHHHHHHHHHHHHHHHHHHHHHHHHHHHHH
HHHHHHHHHHHHHHHHHHHHHHHHHHHHHHHH
HHHHHHHHHHHHHHHHHHHHHHHHHHHHHHHH


