jmAAAAAAUTTTTTTTTTTTTTTTTTTTTPQO
baBBBBBBVWWWWWWWWWWWWWWWWWWWWRSO
HI$%%%%%%%%%%%%%%%%%%%%%%%%>(MNO
HI(jmAAAAAUTTTTTTTTTTTTTTTPQ<MNO
HI<baBBBBBVWWWWWWWWWWWWWWWRS<MNO
HI<HI$%%%%%%%%%%%%%%%%%%>(MN<MNO
HI<HI(OOOOOOOOOOOOOOOOOOO<MN<MNO
HI<HI<OOOOOOOOOOOOOOOOOOO<MN<MNO
HI<HI)OOOOOOOOOOOOOOOOOOO<MN<MNO
HI<twAOOOOOOOOOOOOOOOOOOO<JK<MNO
HI<upBOOOOOOOOOOOOOOOOOOO)HI<MNO
HI)$%%%%%%%%%%%%%%%%%%%%%>HI<JKL
twAAAAAAAAAAAAAAAAAAAAAAAADE<HIC
upBBBBBBBBBBBBBBBBBBBBBBBBFG)HIC
$%%%%%%%%%%%%%%%%%%%%%%%%%%%>HIC
AAAAAAAAAAAAAAAAAAAAAAAAAAAAADEC
BBBBBBBBBBBBBBBBBBBBBBBBBBBBBFGC
CCCCCCCCCCCCCCCCCCCCCCCCCCCCCCCC


